64
32
................................................................
...........@@@@@@@@...........@@@@@@.....@@@@@@@@@@@@.........@.
...........@@@@@@@.............@@@@........@@@@@@@@@............
...........@@@@@@@.............@@@..........@@@@@@@.............
............@@@@@@.............@@@...........@@@@@..............
..............@@@@@.............................................
...............@@@@.............................................
................@@@.............................................
................................................................
..............................................................@.
.....................................................@@....@@@@.
....................................................@@@@@@@@@@@.
....................................................@@@@@@@@@@@.
.....................................................@@@@@@@@@@.
.....................................@@@.....................@@.
.....................................@@.......................@.
....................................@@@.........................
....................................@@@.........................
...................................@@@@.........................
...................................@@@@.........................
..................................@@@@@.........................
...................@@.............@@@@..........................
....................@.............@@@...........................
..................................@@............................
..............@@@@.................@............................
..........@@@@@@@@................@.............................
.........@@@@@@@@@................@@.....................@....@.
.........@@@@@@@@@...............@@@...................@@@@@@@@.
.........@@@@@@@@@................@@...........@.......@@@@@@@@.
..........@@@@@@@@................@@..........@@@@.....@@@@@@@@.
..........@@@@@@@@@.............@@@@@@......@@@@@@@...@@@@@@@@@.
................................................................
