64
32
................................................................
.............@@@@@@@@.........@@@@@@............@@@@@.........@.
.............@@@@@@@............................................
..............@@@@@@............................................
..............@@@@@@............................................
...............@@@@@@...........................................
................@@@@@...........................................
.................@@@............................................
................................................................
.............................................@@@................
............................................@@@@@...............
............................................@@@@@...............
............................................@@@@@@..............
..............@@@............................@@@@@..............
.............@@@@@@...........................@@@@..............
...........@@@@@@@@@@..........................@@...............
........@@@@@@@@@@@@@@..........................................
......@@@@@@@@@@@.@@@@@.........................................
......@@@@@@@@@@....@@............................@@@...........
.....@@@@@@@@@@..................................@@@@@..........
......@@@@@@@@...................................@@@@@@.........
.................................................@@@@@@@........
.................................................@@@@@@@........
..................................................@@@@@@@.......
....................................................@@@@@.......
......................................................@@@.......
...........................@@@@...............................@.
..........................@@@@@@@...@@@@...@@@@..............@@.
.........................@@@@@@@@@@@@@@@@@@@@@@@.............@@.
...@@...........@@@......@@@@@@@@@@@@@@@@@@@@@@@@............@@.
.@@@@@.........@@@@@...@@@@@@@@@@@@@@@@@@@@@@@@@@@@........@@@@.
................................................................
