64
32
................................................................
..................................................@@@@@@@@@@@@@.
....................................................@@@@..@@@@@.
...........................................................@@@@.
.............................................................@@.
..............................................................@.
................................................................
................................................................
................................................................
................................................................
.....................................................@@.........
....................................................@@@@........
...................................................@@@@.........
...................................................@@@..........
..................................................@@............
................................................................
.................@..............................................
................@@@.............................................
................@@@...........................................@.
................@@@...........................................@.
......................................................@......@@.
..................................................@@@@@@.....@@.
.................................................@@@@@@@....@@@.
................................................@@@@@@@.....@@@.
................................................@@@@@@......@@@.
...............................................@@@@@.......@@@@.
................................................@@@@.......@@@@.
.................................................@........@@@@@.
..........................................................@@@@@.
.........................................................@@@@@@.
........................................................@@@@@@@.
................................................................
