64
32
................................................................
.....................@@@@@@@@@..................@@@...........@.
......................@@@@@@@...................................
.......................@@@@@....................................
........................@@@.......................@.............
................................................................
..................................@@@@@.........................
.................................@@@@@@.........................
...............@@@..............@@@@@@@.........................
.............@@@@@@.............@@@@@@..........................
............@@@@@@@@.............@@@@...........................
............@@@@@@@@@...........................................
...........@@@@@@@@@@.........................................@.
...........@@@@@@@@@@.......................................@@@.
...........@@@@@@@@........................................@@@@.
.............@.............................................@@@@.
............................................................@@@.
............................................................@@@.
.............................................................@@.
..............................................................@.
..............................................................@.
................................................................
....................................................@@@.........
...............@@..........................@........@@@.........
...............@@@.......................@@@@@.......@@.........
...............@@@.......................@@@@@@.................
..............@@@@.......................@@@@@@@................
..............@@@@.......................@@@@@@@@...............
..............@@@.......@.................@@@@@@@...............
..............@@@@....@@@@................@@@@@@@.............@.
..............@@@@@..@@@@@@@.............@@@@@@@@@...........@@.
................................................................
