64
32
................................................................
.@@@@@@......@@@@@@@@@@..........@@@@@.............@@@@@......@.
.@............@@@@@@@@............@@@...........................
...............@@@@@@@..........................................
................@@@@@...........................................
.................@@@@...........................................
..................@@............................................
................................................................
................................................................
................................@...............................
...............................@@@..............................
...............................@@@............@@................
..............................................@@@...............
..............................................@@................
................................................................
................................................................
................................................................
................................................................
................................................................
................................................................
................................................................
................................................................
..............................................................@.
..............................@.............................@@@.
...............................@...........................@@@@.
...........................................................@@@@.
.@...........................................@@............@@@@.
.@@.........................................@@@@...........@@@@.
.@@@@............@@.........................@@@............@@@@.
.@@@@@..........@@@@........................@@@............@@@@.
.@@@@@@@.......@@@@@@......................@@@@@..........@@@@@.
................................................................
