64
32
................................................................
.........@@@@@@@@@@@...................@@@@@@@................@.
.........@@@@@@@@@.......................@@@....................
.........@@@@@@@@@..............................................
..........@@@@@@@@..............................................
...........@@@@@@...............................................
............@@@@@...............................................
..............@@................................................
................................................................
................................................................
................................................................
................................................................
...........................@@..........................@@.......
........................@@@@@@@.......................@@@@......
........................@@@@@@@.......................@@@@@.....
........................@@@@@@@.......................@@@@@.....
...@......................@@@@@........................@@@@.....
...@........................@...........................@@......
................................................................
................................................................
................................................................
........................................@@@...@@@@@@@@@.........
.....................................@@@@@@@...@@@@@@@@.........
....................................@@@@@@@.........@@@.........
.....................................@@.......................@.
..............................................................@.
..............................................................@.
..............................................................@.
..............................................................@.
.........................@@@..................................@.
........................@@@@@@....................@@@@@@......@.
................................................................
