64
32
................................................................
...........@@@@@@...@@@@@@@@................................@@@.
............@@@@@....@@@@@@...................................@.
............@@@@@.....@@@@....................................@.
..............@@@@....@@@@......................................
...............@@@@.............................................
.@..............@@@.............................................
.@@..............@@...........@.................................
.@@........................@@@@@..............................@.
.@.........@.............@@@@@@@..............................@.
.........@@@@...........@@@@@@@..............................@@.
.........@@@@..........@@@@@@...............................@@@.
.........@@@...........@@@@......................@@........@@@@.
......................@@@@......................@@@@.......@@@@.
......................@@@@.....................@@@@.........@@@.
......................@@@.......................@@...........@@.
.......................@@.....................................@.
................................................................
................................................................
................................................................
................................................................
................................................................
................................................................
................................................................
................................................................
................................................................
................................................................
................................................................
....................................................@@@.........
....................................................@@@@........
.........................................@@@@@@...@@@@@@@.....@.
................................................................
