64
32
................................................................
...........@@@@..............................@@@@@@@@...@@@@@@@.
...........@@.................................@@@@@@.....@@@@@@.
...........@@..................................@@@@@......@@@@@.
..........@@@..................................@@@@..........@@.
...........@@....................................@............@.
................................................................
....................@...........................................
...................@@@..........................................
...................@@@..........................................
.....................@..........................................
................................................................
................................................................
..............................@@@...............................
..............................@@@@..............................
..............................@@@@..............................
..............................@@@.......@@....................@.
......................................@@@@@..................@@.
.....................................@@@@@@..................@@.
.....................................@@@@@@..................@@.
.....................................@@@@@....................@.
.....................................@@@@.....................@.
....................................@@@@......................@.
....................................@@@@.....................@@.
....................................@@@.................@@@@@@@.
........................................................@@@@@@@.
.........................................................@@@@@@.
..........................................................@@@@@.
...............................................@@............@@.
.............................................@@@@@...........@@.
............................................@@@@@@@@.........@@.
................................................................
