64
32
................................................................
.....................@@@@@@@@@................................@.
.......................@@@@@@...................................
.......................@@@@@@...................................
.......................@@@@@@...................................
........................@@@@@...................................
.........................@@@@...........................@@......
.........................@@@............................@@@@.@@.
..........................@..............................@@@@@@.
..........................................................@@@@@.
...........................................................@@@@.
.............................................@@............@@@@.
.............................................@@.............@@@.
.............................................................@@.
..............................................................@.
................................................................
................................................................
..............................................................@.
.............................................................@@.
.............................................................@@.
..............................................................@.
................................................................
................................................................
................................................................
..............................................................@.
.............................................................@@.
...........................................................@@@@.
...........................................................@@@@.
...........................................................@@@@.
.............@@................@@@..@@@...................@@@@@.
............@@@@@............@@@@@@@@@@@@................@@@@@@.
................................................................
