64
32
................................................................
...............@@@@@@.............@@@@@@@@......@@@@@@@@......@.
....................................@@@@@@........@@@@@.........
.....@@@@...........................@@@@@@.........@@@..........
....@@@@@@...........................@@@@@......................
...@@@@@@@@............................@@@@.....................
...@@@@@@@@.............................@@@@@...................
...@@@@@@@@..............................@@@@@@.................
...@@@@@@..................................@@@........@@@.......
.............................................@.......@@@@@......
....................................................@@@@@@@.....
......................................@@@...........@@@@@@@.....
.....................................@@@@............@@@@@@.....
.....................................@@@@@...........@@@@@@.....
.....................................@@@@@............@@@@@.....
....................................@@@@@@............@@@@@.....
....................................@@@@@.............@@@@@.....
....................................@@@@@.............@@@@......
...................................@@@@@...............@@@......
...................................@@@@@........................
....................................@@@.........................
................................................................
................................................................
................................................................
...........................................@@...................
.........................................@@@@...................
.........................@@..............@@@@...................
........................@@@@.............@@@@.................@.
.......................@@@@@..................................@.
.......................@@@@@@..............................@@@@.
..............@@@@...@@@@@@@@@............................@@@@@.
................................................................
